#############
#@....#B...q#
#.....#.....#
#.....s.....#
#s....Bk....#
#############